11111111111111111111111111111111
1P000000000010001000000000011001
10000C000010000110000C0000111011
1C00000C111010011C00000C11111011
10000000000100010000000000011001
1110000000001000011000E000011001
11111111111111111111111111111111