1111111111111
1P000010000C1
10000000E0001
1111111111111