11111111111111111111111111
10010000000C11000001000101
10000111110000000111000101
1P0011E00000C1110CC0011011
10001100000100000010C00001
11111111111111111111111111