1111111111111111111111111111111111
1E0P00000000000C00000C000000000001
1110001111000001110000100000000001
1000000000000000C10000000000000001
1001100111101011111010111100000011
1011110111111C0111C100011100000001
1000000000000000000000000000000001
1111111111111111111111111111111111